11111111111111111
10000000000000011
11110001111111111
10000000000000011
100000C1111100011
100E000100010C011
10000P0100010W011
11111111111111111